R 400 300

NO ./images/N.xpm
SO ./images/S.xpm
WE ./images/W.xpm
EA ./images/E.xpm

S ./images/ITEM.xpm
F 248,248,255
C 25,25,112

1111111111111111111111111111111111111111111111111111111111111111111111111111111111111111111111111111
10000S0000000000000000000000000000000000000000000000000000000000000000000000000000000000000000000001
1020202020202020202020202020202020202020202020202020202020202020202020202020202020202020202020202021
1020202020202020202020202020202020202020202020202020202020202020202020202020202020202020202020202021
1020202020202020202020202020202020202020202020202020202020202020202020202020202020202020202020202021
1020202020202020202020202020202020202020202020202020202020202020202020202020202020202020202020202021
1020202020202020202020202020202020202020202020202020202020202020202020202020202020202020202020202021
1020202020202020202020202020202020202020202020202020202020202020202020202020202020202020202020202021
1020202020202020202020202020202020202020202020202020202020202020202020202020202020202020202020202021
1020202020202020202020202020202020202020202020202020202020202020202020202020202020202020202020202021
1020202020202020202020202020202020202020202020202020202020202020202020202020202020202020202020202021
1020202020202020202020202020202020202020202020202020202020202020202020202020202020202020202020202021
1020202020202020202020202020202020202020202020202020202020202020202020202020202020202020202020202021
1020202020202020202020202020202020202020202020202020202020202020202020202020202020202020202020202021
1020202020202020202020202020202020202020202020202020202020202020202020202020202020202020202020202021
1020202020202020202020202020202020202020202020202020202020202020202020202020202020202020202020202021
1020202020202020202020202020202020202020202020202020202020202020202020202020202020202020202020202021
1020202020202020202020202020202020202020202020202020202020202020202020202020202020202020202020202021
1020202020202020202020202020202020202020202020202020202020202020202020202020202020202020202020202021
1020202020202020202020202020202020202020202020202020202020202020202020202020202020202020202020202021
1020202020202020202020202020202020202020202020202020202020202020202020202020202020202020202020202021
1020202020202020202020202020202020202020202020202020202020202020202020202020202020202020202020202021
1020202020202020202020202020202020202020202020202020202020202020202020202020202020202020202020202021
1020202020202020202020202020202020202020202020202020202020202020202020202020202020202020202020202021
1020202020202020202020202020202020202020202020202020202020202020202020202020202020202020202020202021
1020202020202020202020202020202020202020202020202020202020202020202020202020202020202020202020202021
1020202020202020202020202020202020202020202020202020202020202020202020202020202020202020202020202021
1020202020202020202020202020202020202020202020202020202020202020202020202020202020202020202020202021
1020202020202020202020202020202020202020202020202020202020202020202020202020202020202020202020202021
1020202020202020202020202020202020202020202020202020202020202020202020202020202020202020202020202021
1020202020202020202020202020202020202020202020202020202020202020202020202020202020202020202020202021
1020202020202020202020202020202020202020202020202020202020202020202020202020202020202020202020202021
1020202020202020202020202020202020202020202020202020202020202020202020202020202020202020202020202021
1020202020202020202020202020202020202020202020202020202020202020202020202020202020202020202020202021
1020202020202020202020202020202020202020202020202020202020202020202020202020202020202020202020202021
1020202020202020202020202020202020202020202020202020202020202020202020202020202020202020202020202021
1020202020202020202020202020202020202020202020202020202020202020202020202020202020202020202020202021
1020202020202020202020202020202020202020202020202020202020202020202020202020202020202020202020202021
1020202020202020202020202020202020202020202020202020202020202020202020202020202020202020202020202021
1020202020202020202020202020202020202020202020202020202020202020202020202020202020202020202020202021
1020202020202020202020202020202020202020202020202020202020202020202020202020202020202020202020202021
1020202020202020202020202020202020202020202020202020202020202020202020202020202020202020202020202021
1020202020202020202020202020202020202020202020202020202020202020202020202020202020202020202020202021
1020202020202020202020202020202020202020202020202020202020202020202020202020202020202020202020202021
1020202020202020202020202020202020202020202020202020202020202020202020202020202020202020202020202021
1020202020202020202020202020202020202020202020202020202020202020202020202020202020202020202020202021
1020202020202020202020202020202020202020202020202020202020202020202020202020202020202020202020202021
1020202020202020202020202020202020202020202020202020202020202020202020202020202020202020202020202021
1020202020202020202020202020202020202020202020202020202020202020202020202020202020202020202020202021
1020202020202020202020202020202020202020202020202020202020202020202020202020202020202020202020202021
1020202020202020202020202020202020202020202020202020202020202020202020202020202020202020202020202021
1020202020202020202020202020202020202020202020202020202020202020202020202020202020202020202020202021
1020202020202020202020202020202020202020202020202020202020202020202020202020202020202020202020202021
1020202020202020202020202020202020202020202020202020202020202020202020202020202020202020202020202021
1020202020202020202020202020202020202020202020202020202020202020202020202020202020202020202020202021
1020202020202020202020202020202020202020202020202020202020202020202020202020202020202020202020202021
1020202020202020202020202020202020202020202020202020202020202020202020202020202020202020202020202021
1020202020202020202020202020202020202020202020202020202020202020202020202020202020202020202020202021
1020202020202020202020202020202020202020202020202020202020202020202020202020202020202020202020202021
1020202020202020202020202020202020202020202020202020202020202020202020202020202020202020202020202021
1020202020202020202020202020202020202020202020202020202020202020202020202020202020202020202020202021
1020202020202020202020202020202020202020202020202020202020202020202020202020202020202020202020202021
1020202020202020202020202020202020202020202020202020202020202020202020202020202020202020202020202021
1020202020202020202020202020202020202020202020202020202020202020202020202020202020202020202020202021
1020202020202020202020202020202020202020202020202020202020202020202020202020202020202020202020202021
1020202020202020202020202020202020202020202020202020202020202020202020202020202020202020202020202021
1020202020202020202020202020202020202020202020202020202020202020202020202020202020202020202020202021
1020202020202020202020202020202020202020202020202020202020202020202020202020202020202020202020202021
1020202020202020202020202020202020202020202020202020202020202020202020202020202020202020202020202021
1020202020202020202020202020202020202020202020202020202020202020202020202020202020202020202020202021
1020202020202020202020202020202020202020202020202020202020202020202020202020202020202020202020202021
1020202020202020202020202020202020202020202020202020202020202020202020202020202020202020202020202021
1020202020202020202020202020202020202020202020202020202020202020202020202020202020202020202020202021
1020202020202020202020202020202020202020202020202020202020202020202020202020202020202020202020202021
1020202020202020202020202020202020202020202020202020202020202020202020202020202020202020202020202021
1020202020202020202020202020202020202020202020202020202020202020202020202020202020202020202020202021
1020202020202020202020202020202020202020202020202020202020202020202020202020202020202020202020202021
1020202020202020202020202020202020202020202020202020202020202020202020202020202020202020202020202021
1020202020202020202020202020202020202020202020202020202020202020202020202020202020202020202020202021
1020202020202020202020202020202020202020202020202020202020202020202020202020202020202020202020202021
1020202020202020202020202020202020202020202020202020202020202020202020202020202020202020202020202021
1020202020202020202020202020202020202020202020202020202020202020202020202020202020202020202020202021
1020202020202020202020202020202020202020202020202020202020202020202020202020202020202020202020202021
1020202020202020202020202020202020202020202020202020202020202020202020202020202020202020202020202021
1020202020202020202020202020202020202020202020202020202020202020202020202020202020202020202020202021
1020202020202020202020202020202020202020202020202020202020202020202020202020202020202020202020202021
1020202020202020202020202020202020202020202020202020202020202020202020202020202020202020202020202021
1020202020202020202020202020202020202020202020202020202020202020202020202020202020202020202020202021
1020202020202020202020202020202020202020202020202020202020202020202020202020202020202020202020202021
1020202020202020202020202020202020202020202020202020202020202020202020202020202020202020202020202021
1020202020202020202020202020202020202020202020202020202020202020202020202020202020202020202020202021
1020202020202020202020202020202020202020202020202020202020202020202020202020202020202020202020202021
1020202020202020202020202020202020202020202020202020202020202020202020202020202020202020202020202021
1020202020202020202020202020202020202020202020202020202020202020202020202020202020202020202020202021
1020202020202020202020202020202020202020202020202020202020202020202020202020202020202020202020202021
1020202020202020202020202020202020202020202020202020202020202020202020202020202020202020202020202021
1020202020202020202020202020202020202020202020202020202020202020202020202020202020202020202020202021
1020202020202020202020202020202020202020202020202020202020202020202020202020202020202020202020202021
1000000000000000000000000000000000000000000000000000000000000000000000000000000000000000000000000001
1111111111111111111111111111111111111111111111111111111111111111111111111111111111111111111111111111