R 400 300

NO ./images/eagle.xpm
SO ./images/redbrick.xpm
WE ./images/colorstone.xpm
EA ./images/bluestone.xpm


S ./images/pillar.xpm
F 248,248,255
C 25,25,112

        111111111111111111111111
        110000000000020020000001
        100000000000000000000001
        100000000000000000000001
11111111000000000000000002000001
12000000000010000000001111111111
1110000000021000000000010201
1110001111111000000000010001
1000000000001000000000010001
1000000000000000000000000N01
1200000000000000001010010001
110000111010101111101111000111
1111011 1110101 101111012021
1111111 1111111 111111111111