R 400 300

NO ./images/N.xpm
SO ./images/S.xpm
WE ./images/W.xpm
EA ./images/E.xpm

S ./images/pillar.xpm
F 248,248,255
C 25,25,112

1111111111111111
1000000000200001
1000000000000001
1000000000000001
1000100010001001
1000000000000001
1002000100N00001
1000000000002001
1000000000000001
1111111111111111